TB_IDN,ZONE_CODE,COUNT,AREA,MIN,MAX,RANGE,MEAN,STD,SUM,VARIETY,MAJORITY,MINORITY,MEDIAN
800603,2,1,0.0025,15237,15237,0,15237.0,0.0,15237.0,1,15237,15237,15237
801204,9,1,0.0025,15360,15360,0,15360.0,0.0,15360.0,1,15360,15360,15360
801101,10,2,0.005,15391,15411,20,15401.0,10.0,30802.0,2,15391,15391,15391
801302,11,3,0.0075,14986,15356,370,15225.3333333,169.472383853,45676.0,3,14986,14986,15334
802003,12,1,0.0025,15345,15345,0,15345.0,0.0,15345.0,1,15345,15345,15345
801215,13,1,0.0025,15226,15226,0,15226.0,0.0,15226.0,1,15226,15226,15226
801206,14,2,0.005,14301,15380,1079,14840.5,539.5,29681.0,2,14301,14301,14301
801207,15,1,0.0025,15320,15320,0,15320.0,0.0,15320.0,1,15320,15320,15320
801217,16,1,0.0025,15429,15429,0,15429.0,0.0,15429.0,1,15429,15429,15429
802001,17,1,0.0025,15289,15289,0,15289.0,0.0,15289.0,1,15289,15289,15289
800305,18,2,0.005,15290,15327,37,15308.5,18.5,30617.0,2,15290,15290,15290
801105,19,4,0.01,15154,15396,242,15234.25,95.4839646223,60937.0,4,15154,15154,15177
801212,20,1,0.0025,15350,15350,0,15350.0,0.0,15350.0,1,15350,15350,15350
801003,21,2,0.005,15103,15171,68,15137.0,34.0,30274.0,2,15103,15103,15103
800302,22,3,0.0075,15101,15350,249,15255.3333333,110.061598914,45766.0,3,15101,15101,15315
801208,23,1,0.0025,15349,15349,0,15349.0,0.0,15349.0,1,15349,15349,15349
801107,25,3,0.0075,15381,15477,96,15413.0,45.2548339959,46239.0,2,15381,15477,15381
801213,26,1,0.0025,15308,15308,0,15308.0,0.0,15308.0,1,15308,15308,15308
801218,28,1,0.0025,15545,15545,0,15545.0,0.0,15545.0,1,15545,15545,15545
800906,31,2,0.005,14986,15172,186,15079.0,93.0,30158.0,2,14986,14986,14986
801216,32,1,0.0025,15429,15429,0,15429.0,0.0,15429.0,1,15429,15429,15429
801001,33,2,0.005,15132,15378,246,15255.0,123.0,30510.0,2,15132,15132,15132
801303,34,2,0.005,15374,15382,8,15378.0,4.0,30756.0,2,15374,15374,15374
802304,35,1,0.0025,15360,15360,0,15360.0,0.0,15360.0,1,15360,15360,15360
801203,36,1,0.0025,15135,15135,0,15135.0,0.0,15135.0,1,15135,15135,15135
801104,37,4,0.01,15304,15477,173,15376.0,67.427739099,61504.0,4,15304,15304,15327
801214,38,3,0.0075,15102,15356,254,15257.6666667,111.338323242,45773.0,3,15102,15102,15315
800407,39,1,0.0025,15100,15100,0,15100.0,0.0,15100.0,1,15100,15100,15100
800112,40,1,0.0025,15204,15204,0,15204.0,0.0,15204.0,1,15204,15204,15204
800304,41,4,0.01,15095,15296,201,15222.75,79.8165866221,60891.0,4,15095,15095,15216
800106,42,2,0.005,15344,15363,19,15353.5,9.5,30707.0,2,15344,15344,15344
800405,43,1,0.0025,15074,15074,0,15074.0,0.0,15074.0,1,15074,15074,15074
800303,46,1,0.0025,15357,15357,0,15357.0,0.0,15357.0,1,15357,15357,15357
801106,47,1,0.0025,15137,15137,0,15137.0,0.0,15137.0,1,15137,15137,15137
801103,48,1,0.0025,15193,15193,0,15193.0,0.0,15193.0,1,15193,15193,15193
800122,49,2,0.005,15365,15368,3,15366.5,1.5,30733.0,2,15365,15365,15365
802202,50,2,0.005,15225,15244,19,15234.5,9.5,30469.0,2,15225,15225,15225
801210,51,1,0.0025,15375,15375,0,15375.0,0.0,15375.0,1,15375,15375,15375
802004,53,2,0.005,15357,15368,11,15362.5,5.5,30725.0,2,15357,15357,15357
802201,54,7,0.0175,15077,15318,241,15175.0,71.7216843082,106225.0,7,15077,15077,15172
801102,55,3,0.0075,15137,15434,297,15274.0,122.335603975,45822.0,3,15137,15137,15251
800301,56,2,0.005,15171,15237,66,15204.0,33.0,30408.0,2,15171,15171,15171
800101,57,1,0.0025,15189,15189,0,15189.0,0.0,15189.0,1,15189,15189,15189
800119,58,1,0.0025,15417,15417,0,15417.0,0.0,15417.0,1,15417,15417,15417
800416,59,2,0.005,15199,15266,67,15232.5,33.5,30465.0,2,15199,15199,15199
800113,60,1,0.0025,15189,15189,0,15189.0,0.0,15189.0,1,15189,15189,15189
801202,61,3,0.0075,15364,15375,11,15367.6666667,5.18544973126,46103.0,2,15364,15375,15364
810602,62,2,0.005,15062,15091,29,15076.5,14.5,30153.0,2,15062,15062,15062
800807,64,2,0.005,15321,15325,4,15323.0,2.0,30646.0,2,15321,15321,15321
800204,65,3,0.0075,15069,15287,218,15209.6666667,99.6304281946,45629.0,3,15069,15069,15273
800501,66,2,0.005,14971,15131,160,15051.0,80.0,30102.0,2,14971,14971,14971
800120,67,3,0.0075,15301,15372,71,15335.0,29.0631496343,46005.0,3,15301,15301,15332
810301,68,2,0.005,14708,14876,168,14792.0,84.0,29584.0,2,14708,14708,14708
810603,69,2,0.005,15062,15062,0,15062.0,0.0,30124.0,1,15062,15062,15062
800201,70,2,0.005,15173,15244,71,15208.5,35.5,30417.0,2,15173,15173,15173
800205,71,1,0.0025,15272,15272,0,15272.0,0.0,15272.0,1,15272,15272,15272
800403,72,5,0.0125,14820,15269,449,15044.4,163.018526555,75222.0,5,14820,14820,15059
801209,73,1,0.0025,14973,14973,0,14973.0,0.0,14973.0,1,14973,14973,14973
800116,74,2,0.005,15284,15346,62,15315.0,31.0,30630.0,2,15284,15284,15284
801803,75,2,0.005,15205,15312,107,15258.5,53.5,30517.0,2,15205,15205,15205
800410,76,1,0.0025,15157,15157,0,15157.0,0.0,15157.0,1,15157,15157,15157
800406,77,2,0.005,15156,15243,87,15199.5,43.5,30399.0,2,15156,15156,15156
800505,78,2,0.005,15162,15228,66,15195.0,33.0,30390.0,2,15162,15162,15162
800504,79,2,0.005,15091,15277,186,15184.0,93.0,30368.0,2,15091,15091,15091
800121,80,3,0.0075,15268,15288,20,15276.0,8.64098759788,45828.0,3,15268,15268,15272
801802,81,2,0.005,15243,15312,69,15277.5,34.5,30555.0,2,15243,15243,15243
800203,82,1,0.0025,15301,15301,0,15301.0,0.0,15301.0,1,15301,15301,15301
800404,83,1,0.0025,15197,15197,0,15197.0,0.0,15197.0,1,15197,15197,15197
800202,84,1,0.0025,15266,15266,0,15266.0,0.0,15266.0,1,15266,15266,15266
802101,86,1,0.0025,14981,14981,0,14981.0,0.0,14981.0,1,14981,14981,14981
802103,87,1,0.0025,15332,15332,0,15332.0,0.0,15332.0,1,15332,15332,15332
800803,88,2,0.005,14949,15038,89,14993.5,44.5,29987.0,2,14949,14949,14949
800503,89,6,0.015,15067,15194,127,15125.3333333,45.2388721736,90752.0,6,15067,15067,15094
800502,90,3,0.0075,15067,15152,85,15101.0,36.724197291,45303.0,3,15067,15067,15084
802104,92,5,0.0125,15021,15246,225,15098.6,88.2056687521,75493.0,4,15021,15052,15052
801403,93,2,0.005,15295,15302,7,15298.5,3.5,30597.0,2,15295,15295,15295
801408,94,4,0.01,15147,15314,167,15221.5,59.8101162012,60886.0,4,15147,15147,15208
802102,95,12,0.03,14987,15393,406,15220.0833333,133.228161646,182641.0,9,14987,15064,15228
801404,96,1,0.0025,15045,15045,0,15045.0,0.0,15045.0,1,15045,15045,15045
800802,97,1,0.0025,15265,15265,0,15265.0,0.0,15265.0,1,15265,15265,15265
801407,98,1,0.0025,15143,15143,0,15143.0,0.0,15143.0,1,15143,15143,15143
800811,99,1,0.0025,15183,15183,0,15183.0,0.0,15183.0,1,15183,15183,15183
801405,100,2,0.005,15006,15066,60,15036.0,30.0,30072.0,2,15006,15006,15006
800813,101,2,0.005,15400,15416,16,15408.0,8.0,30816.0,2,15400,15400,15400
800804,102,1,0.0025,15336,15336,0,15336.0,0.0,15336.0,1,15336,15336,15336
800409,103,3,0.0075,15066,15152,86,15121.6666667,39.4151691051,45365.0,3,15066,15066,15147
800704,105,1,0.0025,15051,15051,0,15051.0,0.0,15051.0,1,15051,15051,15051
801704,108,2,0.005,15034,15080,46,15057.0,23.0,30114.0,2,15034,15034,15034
801702,109,1,0.0025,14877,14877,0,14877.0,0.0,14877.0,1,14877,14877,14877
801603,112,1,0.0025,15133,15133,0,15133.0,0.0,15133.0,1,15133,15133,15133
800910,113,1,0.0025,14444,14444,0,14444.0,0.0,14444.0,1,14444,14444,14444
801503,117,1,0.0025,14895,14895,0,14895.0,0.0,14895.0,1,14895,14895,14895
801501,118,3,0.0075,14952,15261,309,15074.3333333,134.100294142,45223.0,3,14952,14952,15010
801502,119,3,0.0075,15177,15271,94,15227.3333333,38.6637929965,45682.0,3,15177,15177,15234
801406,120,5,0.0125,15209,15300,91,15246.4,36.4450270957,76232.0,5,15209,15209,15222
801409,121,2,0.005,15262,15306,44,15284.0,22.0,30568.0,2,15262,15262,15262
801402,122,2,0.005,15280,15350,70,15315.0,35.0,30630.0,2,15280,15280,15280
800702,125,1,0.0025,15051,15051,0,15051.0,0.0,15051.0,1,15051,15051,15051
800705,126,6,0.015,14675,15154,479,14988.1666667,153.750248419,89929.0,5,14973,14675,14973
800708,128,1,0.0025,15120,15120,0,15120.0,0.0,15120.0,1,15120,15120,15120
800707,129,1,0.0025,15136,15136,0,15136.0,0.0,15136.0,1,15136,15136,15136
800711,130,1,0.0025,15136,15136,0,15136.0,0.0,15136.0,1,15136,15136,15136
810304,131,2,0.005,15060,15064,4,15062.0,2.0,30124.0,2,15060,15060,15060
810405,132,4,0.01,14937,15141,204,15049.25,74.7207300553,60197.0,4,14937,14937,15036
810803,133,5,0.0125,14891,15484,593,15181.0,193.775127403,75905.0,5,14891,14891,15204
810403,134,4,0.01,15101,15327,226,15185.5,85.5847533151,60742.0,4,15101,15101,15141
810302,135,2,0.005,15010,15010,0,15010.0,0.0,30020.0,1,15010,15010,15010
810305,136,2,0.005,15010,15014,4,15012.0,2.0,30024.0,2,15010,15010,15010
810303,137,3,0.0075,14967,15101,134,15053.0,60.9480653234,45159.0,3,14967,14967,15091
810404,138,3,0.0075,14994,15250,256,15080.0,120.210925737,45240.0,3,14994,14994,14996
810801,140,1,0.0025,15142,15142,0,15142.0,0.0,15142.0,1,15142,15142,15142
810115,141,2,0.005,14682,14861,179,14771.5,89.5,29543.0,2,14682,14682,14682
810406,142,3,0.0075,14996,15219,223,15118.6666667,92.3988936924,45356.0,3,14996,14996,15141
810805,143,1,0.0025,15119,15119,0,15119.0,0.0,15119.0,1,15119,15119,15119
810702,145,1,0.0025,15312,15312,0,15312.0,0.0,15312.0,1,15312,15312,15312
810703,146,1,0.0025,15312,15312,0,15312.0,0.0,15312.0,1,15312,15312,15312
810117,147,3,0.0075,14686,14815,129,14766.0,57.0438427878,44298.0,3,14686,14686,14797
810402,149,2,0.005,14996,15069,73,15032.5,36.5,30065.0,2,14996,14996,14996
810401,150,3,0.0075,15036,15069,33,15058.0,15.5563491861,45174.0,2,15069,15036,15069
810806,151,1,0.0025,15180,15180,0,15180.0,0.0,15180.0,1,15180,15180,15180
810116,152,1,0.0025,14696,14696,0,14696.0,0.0,14696.0,1,14696,14696,14696
810118,153,1,0.0025,15085,15085,0,15085.0,0.0,15085.0,1,15085,15085,15085
810804,154,1,0.0025,15111,15111,0,15111.0,0.0,15111.0,1,15111,15111,15111
810807,155,2,0.005,14981,15230,249,15105.5,124.5,30211.0,2,14981,14981,14981
810204,156,5,0.0125,15086,15162,76,15118.6,31.7086738923,75593.0,5,15086,15086,15104
810203,157,4,0.01,15126,15287,161,15195.5,62.1067629168,60782.0,4,15126,15126,15153
810201,158,4,0.01,15028,15161,133,15106.0,51.908573473,60424.0,4,15028,15028,15091
810111,159,1,0.0025,15049,15049,0,15049.0,0.0,15049.0,1,15049,15049,15049
810506,160,1,0.0025,15064,15064,0,15064.0,0.0,15064.0,1,15064,15064,15064
810509,162,1,0.0025,15110,15110,0,15110.0,0.0,15110.0,1,15110,15110,15110
810501,163,3,0.0075,15064,15110,46,15079.3333333,21.6846079561,45238.0,2,15064,15110,15064
810202,164,3,0.0075,15127,15264,137,15180.0,60.0721788074,45540.0,3,15127,15127,15149
810502,165,4,0.01,14709,15122,413,14880.0,154.134681367,59520.0,4,14709,14709,14796
810505,166,2,0.005,14708,15129,421,14918.5,210.5,29837.0,2,14708,14708,14708
810504,167,3,0.0075,15121,15121,0,15121.0,0.0,45363.0,1,15121,15121,15121
810105,168,3,0.0075,15116,15192,76,15141.3333333,35.8267435799,45424.0,2,15116,15192,15116
810407,169,4,0.01,15114,15233,119,15180.0,48.718579618,60720.0,4,15114,15114,15153
810103,170,6,0.015,15027,15140,113,15095.5,40.7543453716,90573.0,6,15027,15027,15100
810206,171,5,0.0125,15029,15477,448,15202.6,157.678914253,76013.0,5,15029,15029,15180
810808,172,4,0.01,14988,15137,149,15087.75,59.2510548429,60351.0,4,14988,14988,15099
810507,173,2,0.005,14975,15006,31,14990.5,15.5,29981.0,2,14975,14975,14975
810503,174,1,0.0025,15091,15091,0,15091.0,0.0,15091.0,1,15091,15091,15091
810205,175,4,0.01,15148,15219,71,15175.75,29.192250684,60703.0,4,15148,15148,15150
810604,176,1,0.0025,14975,14975,0,14975.0,0.0,14975.0,1,14975,14975,14975
801611,180,1,0.0025,15324,15324,0,15324.0,0.0,15324.0,1,15324,15324,15324
801608,181,1,0.0025,15237,15237,0,15237.0,0.0,15237.0,1,15237,15237,15237
800606,182,1,0.0025,15243,15243,0,15243.0,0.0,15243.0,1,15243,15243,15243
800601,184,1,0.0025,15105,15105,0,15105.0,0.0,15105.0,1,15105,15105,15105
800605,189,1,0.0025,15369,15369,0,15369.0,0.0,15369.0,1,15369,15369,15369
801606,193,1,0.0025,15188,15188,0,15188.0,0.0,15188.0,1,15188,15188,15188
801601,196,2,0.005,15202,15205,3,15203.5,1.5,30407.0,2,15202,15202,15202
