TB_IDN,ZONE_CODE,COUNT,AREA,MIN,MAX,RANGE,MEAN,STD,SUM,VARIETY,MAJORITY,MINORITY,MEDIAN
801304,1,2,0.005,15207,15208,1,15207.5,0.5,30415.0,2,15207,15207,15207
801904,3,2,0.005,15136,15194,58,15165.0,29.0,30330.0,2,15136,15136,15136
800905,4,4,0.01,15154,15222,68,15183.5,27.5726313579,60734.0,4,15154,15154,15161
800909,5,1,0.0025,15197,15197,0,15197.0,0.0,15197.0,1,15197,15197,15197
801701,6,3,0.0075,15040,15085,45,15060.0,18.7082869339,45180.0,3,15040,15040,15055
801903,7,1,0.0025,15206,15206,0,15206.0,0.0,15206.0,1,15206,15206,15206
801204,9,1,0.0025,15361,15361,0,15361.0,0.0,15361.0,1,15361,15361,15361
801101,10,2,0.005,15031,15204,173,15117.5,86.5,30235.0,2,15031,15031,15031
801302,11,4,0.01,15102,15265,163,15191.0,61.7454451761,60764.0,4,15102,15102,15169
802003,12,1,0.0025,15387,15387,0,15387.0,0.0,15387.0,1,15387,15387,15387
801215,13,1,0.0025,15119,15119,0,15119.0,0.0,15119.0,1,15119,15119,15119
801206,14,2,0.005,15361,15398,37,15379.5,18.5,30759.0,2,15361,15361,15361
801207,15,1,0.0025,15398,15398,0,15398.0,0.0,15398.0,1,15398,15398,15398
801217,16,1,0.0025,15127,15127,0,15127.0,0.0,15127.0,1,15127,15127,15127
802001,17,1,0.0025,15375,15375,0,15375.0,0.0,15375.0,1,15375,15375,15375
800305,18,2,0.005,15212,15250,38,15231.0,19.0,30462.0,2,15212,15212,15212
801105,19,4,0.01,14977,15162,185,15094.5,71.5069926651,60378.0,4,14977,14977,15099
801212,20,1,0.0025,15587,15587,0,15587.0,0.0,15587.0,1,15587,15587,15587
801003,21,2,0.005,15016,15122,106,15069.0,53.0,30138.0,2,15016,15016,15016
800302,22,3,0.0075,14966,15150,184,15042.6666667,78.1849658753,45128.0,3,14966,14966,15012
800911,24,4,0.01,15105,15178,73,15148.25,28.9773618537,60593.0,4,15105,15105,15139
801107,25,3,0.0075,14844,15068,224,14967.0,92.761342523,44901.0,3,14844,14844,14989
801213,26,1,0.0025,15069,15069,0,15069.0,0.0,15069.0,1,15069,15069,15069
800912,27,1,0.0025,14990,14990,0,14990.0,0.0,14990.0,1,14990,14990,14990
801218,28,1,0.0025,15063,15063,0,15063.0,0.0,15063.0,1,15063,15063,15063
801301,30,5,0.0125,15120,15257,137,15189.8,45.5868402063,75949.0,5,15120,15120,15201
800906,31,3,0.0075,15042,15180,138,15105.6666667,56.8409085863,45317.0,3,15042,15042,15095
801216,32,1,0.0025,15095,15095,0,15095.0,0.0,15095.0,1,15095,15095,15095
801001,33,2,0.005,14851,15029,178,14940.0,89.0,29880.0,2,14851,14851,14851
801303,34,2,0.005,15128,15295,167,15211.5,83.5,30423.0,2,15128,15128,15128
802304,35,1,0.0025,15322,15322,0,15322.0,0.0,15322.0,1,15322,15322,15322
801203,36,1,0.0025,15107,15107,0,15107.0,0.0,15107.0,1,15107,15107,15107
801104,37,4,0.01,14978,15121,143,15056.0,51.0734764824,60224.0,4,14978,14978,15058
801214,38,3,0.0075,15231,15392,161,15292.3333333,71.0977417987,45877.0,3,15231,15231,15254
800407,39,1,0.0025,15151,15151,0,15151.0,0.0,15151.0,1,15151,15151,15151
800112,40,1,0.0025,15180,15180,0,15180.0,0.0,15180.0,1,15180,15180,15180
800304,41,4,0.01,15094,15227,133,15141.25,53.5694642497,60565.0,4,15094,15094,15098
800106,42,2,0.005,15200,15217,17,15208.5,8.5,30417.0,2,15200,15200,15200
800405,43,1,0.0025,15195,15195,0,15195.0,0.0,15195.0,1,15195,15195,15195
800115,44,1,0.0025,15260,15260,0,15260.0,0.0,15260.0,1,15260,15260,15260
801801,45,1,0.0025,14997,14997,0,14997.0,0.0,14997.0,1,14997,14997,14997
800303,46,1,0.0025,15139,15139,0,15139.0,0.0,15139.0,1,15139,15139,15139
801106,47,2,0.005,15103,15190,87,15146.5,43.5,30293.0,2,15103,15103,15103
801103,48,2,0.005,15142,15154,12,15148.0,6.0,30296.0,2,15142,15142,15142
800122,49,2,0.005,15395,15503,108,15449.0,54.0,30898.0,2,15395,15395,15395
802202,50,2,0.005,15058,15109,51,15083.5,25.5,30167.0,2,15058,15058,15058
801210,51,1,0.0025,15436,15436,0,15436.0,0.0,15436.0,1,15436,15436,15436
801002,52,1,0.0025,15006,15006,0,15006.0,0.0,15006.0,1,15006,15006,15006
802004,53,2,0.005,15395,15397,2,15396.0,1.0,30792.0,2,15395,15395,15395
802201,54,7,0.0175,14714,15096,382,14968.8571429,131.612449011,104782.0,6,15024,14714,15024
801102,55,3,0.0075,15066,15145,79,15105.3333333,32.2524762183,45316.0,3,15066,15066,15105
800301,56,2,0.005,14978,15055,77,15016.5,38.5,30033.0,2,14978,14978,14978
800101,57,1,0.0025,15405,15405,0,15405.0,0.0,15405.0,1,15405,15405,15405
800119,58,1,0.0025,15215,15215,0,15215.0,0.0,15215.0,1,15215,15215,15215
800416,59,2,0.005,15126,15159,33,15142.5,16.5,30285.0,2,15126,15126,15126
800113,60,1,0.0025,15345,15345,0,15345.0,0.0,15345.0,1,15345,15345,15345
801202,61,3,0.0075,15087,15285,198,15219.0,93.3380951166,45657.0,2,15285,15087,15285
810602,62,4,0.01,15053,15276,223,15159.75,79.2413244463,60639.0,4,15053,15053,15146
810601,63,8,0.02,15070,15200,130,15138.125,43.4034488837,121105.0,8,15070,15070,15147
800807,64,2,0.005,15101,15260,159,15180.5,79.5,30361.0,2,15101,15101,15101
800204,65,3,0.0075,15003,15272,269,15121.0,112.270506664,45363.0,3,15003,15003,15088
800501,66,2,0.005,14956,15047,91,15001.5,45.5,30003.0,2,14956,14956,14956
800120,67,3,0.0075,15084,15388,304,15263.6666667,130.128995829,45791.0,3,15084,15084,15319
810301,68,2,0.005,14567,14643,76,14605.0,38.0,29210.0,2,14567,14567,14567
810603,69,3,0.0075,15075,15208,133,15119.3333333,62.6968012651,45358.0,2,15075,15208,15075
800201,70,2,0.005,15163,15230,67,15196.5,33.5,30393.0,2,15163,15163,15163
800205,71,1,0.0025,15220,15220,0,15220.0,0.0,15220.0,1,15220,15220,15220
800403,72,5,0.0125,14984,15197,213,15127.6,74.5938335254,75638.0,5,14984,14984,15154
801209,73,1,0.0025,15161,15161,0,15161.0,0.0,15161.0,1,15161,15161,15161
800116,74,3,0.0075,15172,15452,280,15300.3333333,115.494107594,45901.0,3,15172,15172,15277
801803,75,3,0.0075,15082,15183,101,15118.0,46.0506967012,45354.0,3,15082,15082,15089
800410,76,1,0.0025,15144,15144,0,15144.0,0.0,15144.0,1,15144,15144,15144
800406,77,2,0.005,15149,15185,36,15167.0,18.0,30334.0,2,15149,15149,15149
800505,78,2,0.005,15165,15166,1,15165.5,0.5,30331.0,2,15165,15165,15165
800504,79,2,0.005,15120,15148,28,15134.0,14.0,30268.0,2,15120,15120,15120
800121,80,3,0.0075,15040,15556,516,15231.3333333,230.791873533,45694.0,3,15040,15040,15098
801802,81,2,0.005,15062,15160,98,15111.0,49.0,30222.0,2,15062,15062,15062
800203,82,1,0.0025,15319,15319,0,15319.0,0.0,15319.0,1,15319,15319,15319
800404,83,1,0.0025,15108,15108,0,15108.0,0.0,15108.0,1,15108,15108,15108
800202,84,1,0.0025,15309,15309,0,15309.0,0.0,15309.0,1,15309,15309,15309
800806,85,1,0.0025,15194,15194,0,15194.0,0.0,15194.0,1,15194,15194,15194
802101,86,3,0.0075,15008,15268,260,15181.3333333,122.565175406,45544.0,2,15268,15008,15268
802103,87,2,0.005,15011,15162,151,15086.5,75.5,30173.0,2,15011,15011,15011
800803,88,3,0.0075,15096,15363,267,15203.3333333,115.112505354,45610.0,3,15096,15096,15151
800503,89,6,0.015,14931,15066,135,15020.5,44.5374374356,90123.0,6,14931,14931,15015
800502,90,3,0.0075,14950,15120,170,15038.6666667,69.5956575914,45116.0,3,14950,14950,15046
800801,91,1,0.0025,15252,15252,0,15252.0,0.0,15252.0,1,15252,15252,15252
802104,92,5,0.0125,14887,15067,180,14994.4,66.4638247471,74972.0,5,14887,14887,14979
801403,93,2,0.005,14923,15108,185,15015.5,92.5,30031.0,2,14923,14923,14923
801408,94,4,0.01,14815,15078,263,14954.5,119.038859202,59818.0,4,14815,14815,14858
802102,95,16,0.04,14884,15198,314,15036.25,84.9650663508,240580.0,16,14884,14884,15022
801404,96,1,0.0025,14993,14993,0,14993.0,0.0,14993.0,1,14993,14993,14993
800802,97,1,0.0025,15119,15119,0,15119.0,0.0,15119.0,1,15119,15119,15119
801407,98,3,0.0075,14929,15149,220,15027.3333333,91.3175168786,45082.0,3,14929,14929,15004
800811,99,3,0.0075,15144,15246,102,15188.6666667,42.5936875869,45566.0,3,15144,15144,15176
801405,100,2,0.005,15094,15179,85,15136.5,42.5,30273.0,2,15094,15094,15094
800813,101,2,0.005,15339,15495,156,15417.0,78.0,30834.0,2,15339,15339,15339
800804,102,1,0.0025,15273,15273,0,15273.0,0.0,15273.0,1,15273,15273,15273
800409,103,3,0.0075,14980,15085,105,15035.0,43.0116263352,45105.0,3,14980,14980,15040
800704,105,2,0.005,15217,15217,0,15217.0,0.0,30434.0,1,15217,15217,15217
801605,106,1,0.0025,15342,15342,0,15342.0,0.0,15342.0,1,15342,15342,15342
801704,108,3,0.0075,14991,15180,189,15097.6666667,79.0541305409,45293.0,3,14991,14991,15122
801702,109,8,0.02,14949,15204,255,15094.25,84.3085849721,120754.0,8,14949,14949,15101
801902,110,1,0.0025,15142,15142,0,15142.0,0.0,15142.0,1,15142,15142,15142
801703,111,2,0.005,15127,15151,24,15139.0,12.0,30278.0,2,15127,15127,15127
800910,113,2,0.005,15094,15120,26,15107.0,13.0,30214.0,2,15094,15094,15094
801905,114,2,0.005,15130,15160,30,15145.0,15.0,30290.0,2,15130,15130,15130
800701,115,1,0.0025,15205,15205,0,15205.0,0.0,15205.0,1,15205,15205,15205
800908,116,2,0.005,15082,15185,103,15133.5,51.5,30267.0,2,15082,15082,15082
801503,117,3,0.0075,15130,15180,50,15157.6666667,20.7578633032,45473.0,3,15130,15130,15163
801501,118,3,0.0075,15086,15176,90,15138.3333333,38.1779459314,45415.0,3,15086,15086,15153
801502,119,4,0.01,15055,15206,151,15115.75,55.4273172723,60463.0,4,15055,15055,15098
801406,120,5,0.0125,15113,15237,124,15160.8,42.4471436023,75804.0,5,15113,15113,15143
801409,121,2,0.005,15104,15256,152,15180.0,76.0,30360.0,2,15104,15104,15104
801402,122,2,0.005,15046,15178,132,15112.0,66.0,30224.0,2,15046,15046,15046
800710,124,3,0.0075,15143,15186,43,15169.0,18.6726180989,45507.0,3,15143,15143,15178
800702,125,1,0.0025,15211,15211,0,15211.0,0.0,15211.0,1,15211,15211,15211
800705,126,6,0.015,15150,15212,62,15178.6666667,23.3713975245,91072.0,5,15150,15172,15172
800708,128,1,0.0025,15195,15195,0,15195.0,0.0,15195.0,1,15195,15195,15195
800707,129,1,0.0025,15225,15225,0,15225.0,0.0,15225.0,1,15225,15225,15225
800711,130,1,0.0025,15225,15225,0,15225.0,0.0,15225.0,1,15225,15225,15225
810304,131,2,0.005,14961,15044,83,15002.5,41.5,30005.0,2,14961,14961,14961
810405,132,4,0.01,15019,15126,107,15086.0,41.4547946563,60344.0,4,15019,15019,15085
810803,133,5,0.0125,15031,15235,204,15101.8,73.0736614656,75509.0,5,15031,15031,15075
810403,134,7,0.0175,14844,15146,302,14998.0,108.371055703,104986.0,6,14844,14969,15055
810302,135,2,0.005,15024,15024,0,15024.0,0.0,30048.0,1,15024,15024,15024
810305,136,2,0.005,14775,15114,339,14944.5,169.5,29889.0,2,14775,14775,14775
810303,137,3,0.0075,15022,15142,120,15100.6666667,55.6496980128,45302.0,3,15022,15022,15138
810404,138,4,0.01,15003,15097,94,15060.5,34.9678423698,60242.0,4,15003,15003,15067
810106,139,4,0.01,15208,15262,54,15239.0,23.2916293977,60956.0,4,15208,15208,15225
810801,140,1,0.0025,15259,15259,0,15259.0,0.0,15259.0,1,15259,15259,15259
810115,141,2,0.005,15162,15405,243,15283.5,121.5,30567.0,2,15162,15162,15162
810406,142,6,0.015,14857,15092,235,14967.6666667,77.146325613,89806.0,4,14990,14857,14990
810805,143,2,0.005,15154,15211,57,15182.5,28.5,30365.0,2,15154,15154,15154
810701,144,2,0.005,14945,15082,137,15013.5,68.5,30027.0,2,14945,14945,14945
810702,145,2,0.005,15004,15073,69,15038.5,34.5,30077.0,2,15004,15004,15004
810703,146,2,0.005,14843,14908,65,14875.5,32.5,29751.0,2,14843,14843,14843
810117,147,3,0.0075,15198,15277,79,15230.3333333,33.8066397158,45691.0,3,15198,15198,15216
810704,148,2,0.005,14949,15031,82,14990.0,41.0,29980.0,2,14949,14949,14949
810402,149,6,0.015,14921,15279,358,15085.5,107.018300616,90513.0,6,14921,14921,15060
810401,150,3,0.0075,14838,15035,197,14961.6666667,87.9482170878,44885.0,3,14838,14838,15012
810806,151,1,0.0025,15024,15024,0,15024.0,0.0,15024.0,1,15024,15024,15024
810116,152,1,0.0025,15228,15228,0,15228.0,0.0,15228.0,1,15228,15228,15228
810118,153,2,0.005,15285,15365,80,15325.0,40.0,30650.0,2,15285,15285,15285
810804,154,1,0.0025,15315,15315,0,15315.0,0.0,15315.0,1,15315,15315,15315
810807,155,2,0.005,15032,15238,206,15135.0,103.0,30270.0,2,15032,15032,15032
810204,156,5,0.0125,14905,15128,223,15007.0,76.9129377933,75035.0,5,14905,14905,14993
810203,157,4,0.01,15030,15105,75,15083.75,31.2999600639,60335.0,3,15105,15030,15095
810201,158,4,0.01,14905,15217,312,15065.0,149.217961385,60260.0,4,14905,14905,14927
810111,159,5,0.0125,15028,15356,328,15192.2,120.409966365,75961.0,5,15028,15028,15216
810506,160,2,0.005,15045,15084,39,15064.5,19.5,30129.0,2,15045,15045,15045
810508,161,1,0.0025,15045,15045,0,15045.0,0.0,15045.0,1,15045,15045,15045
810509,162,1,0.0025,15050,15050,0,15050.0,0.0,15050.0,1,15050,15050,15050
810501,163,3,0.0075,14904,15119,215,15045.3333333,99.9677725847,45136.0,3,14904,14904,15113
810202,164,3,0.0075,14986,15132,146,15056.0,59.7550555741,45168.0,3,14986,14986,15050
810502,165,4,0.01,14728,15005,277,14883.0,124.211513154,59532.0,3,15005,14728,14794
810505,166,3,0.0075,14913,15224,311,15073.3333333,127.149081353,45220.0,3,14913,14913,15083
810504,167,5,0.0125,14976,15107,131,15035.0,42.0713679359,75175.0,5,14976,14976,15030
810105,168,4,0.01,15095,15241,146,15169.25,60.8373857098,60677.0,4,15095,15095,15125
810407,169,5,0.0125,14899,15160,261,15095.6,99.2141118995,75478.0,5,14899,14899,15134
810103,170,6,0.015,15028,15339,311,15221.0,98.9023087024,91326.0,6,15028,15028,15233
810206,171,5,0.0125,14968,15154,186,15040.0,64.5600495663,75200.0,5,14968,14968,15030
810808,172,4,0.01,14958,15314,356,15058.25,148.459379966,60233.0,4,14958,14958,14963
810507,173,3,0.0075,15080,15138,58,15116.3333333,25.8499946269,45349.0,3,15080,15080,15131
810503,174,2,0.005,15143,15170,27,15156.5,13.5,30313.0,2,15143,15143,15143
810205,175,9,0.0225,14831,15160,329,15040.6666667,107.878532516,135366.0,9,14831,14831,15062
810604,176,3,0.0075,15034,15113,79,15084.3333333,35.7055862419,45253.0,3,15034,15034,15106
800904,178,1,0.0025,15185,15185,0,15185.0,0.0,15185.0,1,15185,15185,15185
801611,180,1,0.0025,15024,15024,0,15024.0,0.0,15024.0,1,15024,15024,15024
801608,181,1,0.0025,15014,15014,0,15014.0,0.0,15014.0,1,15014,15014,15014
800606,182,1,0.0025,15152,15152,0,15152.0,0.0,15152.0,1,15152,15152,15152
800913,183,5,0.0125,14920,15027,107,14969.2,40.5728973576,74846.0,5,14920,14920,14985
800601,184,1,0.0025,15074,15074,0,15074.0,0.0,15074.0,1,15074,15074,15074
800903,185,1,0.0025,14918,14918,0,14918.0,0.0,14918.0,1,14918,14918,14918
801305,186,2,0.005,15188,15292,104,15240.0,52.0,30480.0,2,15188,15188,15188
801306,187,1,0.0025,15255,15255,0,15255.0,0.0,15255.0,1,15255,15255,15255
800902,188,1,0.0025,15220,15220,0,15220.0,0.0,15220.0,1,15220,15220,15220
800605,189,1,0.0025,15111,15111,0,15111.0,0.0,15111.0,1,15111,15111,15111
801906,191,1,0.0025,15103,15103,0,15103.0,0.0,15103.0,1,15103,15103,15103
800706,194,2,0.005,15230,15339,109,15284.5,54.5,30569.0,2,15230,15230,15230
800907,195,2,0.005,15196,15202,6,15199.0,3.0,30398.0,2,15196,15196,15196
